const short 20_map0[9][8] = {
{ 0, 0, 0, 0, 0, 0, 0, 0 },
{ 0, 0, 0, 0, 0, 0, 0, 0 },
{ 0, 0, 2, 2, 2, 0, 0, 0 },
{ 0, 0, 6, 6, 6, 0, 0, 0 },
{ 0, 0, 2, 2, 2, 0, 0, 0 },
{ 0, 0, 2, 2, 2, 2, 0, 0 },
{ 0, 0, 2, 2, 2, 2, 0, 0 },
{ 0, 0, 0, 0, 0, 0, 0, 0 },
{ 0, 0, 0, 0, 0, 0, 0, 0 }
};

const short 20_map1[9][8] = {
{ 0, 0, 0, 0, 0, 0, 0, 0 },
{ 0, 1, 1, 1, 1, 1, 0, 0 },
{ 0, 1, 0, 7, 0, 1, 0, 0 },
{ 0, 1, 0, 0, 0, 1, 0, 0 },
{ 0, 1, 4, 4, 4, 1, 1, 0 },
{ 0, 1, 0, 0, 0, 0, 1, 0 },
{ 0, 1, 0, 0, 0, 0, 1, 0 },
{ 0, 1, 1, 1, 1, 1, 1, 0 },
{ 0, 0, 0, 0, 0, 0, 0, 0 }
};

const unsigned short 20_cmap[256] = {
0x0000, 0x6C60, 0x140F, 0x00D6, 0x0000, 0x5EE0, 0x0006, 0x0000,
0x0000, 0x0000, 0x2C00, 0x00D8, 0x0000, 0x0000, 0x0000, 0x0000,
0x1AD4, 0x0000, 0x7000, 0x00D7, 0x0000, 0x0000, 0x0000, 0x0000,
0x3FB5, 0x0000, 0x0000, 0x0000, 0x0000, 0x59E0, 0x0006, 0x0000,
0x0000, 0x0000, 0x0000, 0x0000, 0x0000, 0x74E0, 0x000F, 0x0000,
0x0000, 0x0000, 0x4000, 0x00D6, 0x0000, 0x0000, 0x0000, 0x0000,
0x0000, 0x0000, 0x0400, 0x00D8, 0x0000, 0x0000, 0x0000, 0x0000,
0x1ACE, 0x0000, 0x0000, 0x0000, 0x0000, 0x0000, 0x0000, 0x0000,
0x1B1C, 0x0000, 0x0000, 0x0000, 0x0000, 0x5960, 0x0006, 0x0000,
0x1AF9, 0x0000, 0x0000, 0x0000, 0x0000, 0x4B40, 0x0006, 0x0000,
0x0000, 0x0000, 0x4C00, 0x00D6, 0x0000, 0x0000, 0x0000, 0x0000,
0x0000, 0x0000, 0x0800, 0x01FD, 0x0000, 0x0000, 0x0000, 0x0000,
0x1ACD, 0x0000, 0x0000, 0x0000, 0x0000, 0x0000, 0x0000, 0x0000,
0x1B10, 0x0000, 0x0000, 0x0000, 0x0000, 0x5AE0, 0x0006, 0x0000,
0x1AC9, 0x0000, 0x0000, 0x0000, 0x0000, 0x61A0, 0x0006, 0x0000,
0x0000, 0x0000, 0x0800, 0x00D6, 0x0000, 0x0000, 0x0000, 0x0000,
0x0000, 0x0000, 0x4C00, 0x01FD, 0x0000, 0x0000, 0x0000, 0x0000,
0x1AC1, 0x0000, 0x2000, 0x00D7, 0x0000, 0x0000, 0x0000, 0x0000,
0x3FAB, 0x0000, 0x0000, 0x0000, 0x0000, 0x5920, 0x0006, 0x0000,
0x1AE5, 0x0000, 0x0000, 0x0000, 0x0000, 0x6100, 0x0006, 0x0000,
0x0000, 0x0000, 0x7C00, 0x00D6, 0x0000, 0x5CC0, 0x0006, 0x0000,
0x0000, 0x0000, 0x0C00, 0x00D8, 0x0000, 0x0000, 0x0000, 0x0000,
0x1ADC, 0x0000, 0x0000, 0x00D7, 0x0000, 0x0000, 0x0000, 0x0000,
0x1A56, 0x0000, 0x0000, 0x0000, 0x0000, 0x58E0, 0x0006, 0x0000,
0x1AC4, 0x0000, 0x0000, 0x0000, 0x0000, 0x7580, 0x000F, 0x0000,
0x0000, 0x0000, 0x6400, 0x00D6, 0x0000, 0x0000, 0x0000, 0x0000,
0x0000, 0x0000, 0x0C00, 0x00D7, 0x0000, 0x0000, 0x0000, 0x0000,
0x1AD6, 0x0000, 0x0000, 0x0000, 0x0000, 0x0000, 0x0000, 0x0000,
0x1B17, 0x0000, 0x0000, 0x0000, 0x0000, 0x5900, 0x0006, 0x0000,
0x0000, 0x0000, 0x0000, 0x0000, 0x0000, 0x7420, 0x000F, 0x0000,
0x0000, 0x0000, 0x0C00, 0x00D6, 0x0000, 0x0000, 0x0000, 0x0000,
0x0000, 0x0000, 0x7C00, 0x01FD, 0x0000, 0x0000, 0x0000, 0x7FFF
};

