const short 6_map0[10][8] = {
{ 0, 0, 0, 0, 0, 0, 0, 0 },
{ 0, 0, 0, 0, 0, 0, 0, 0 },
{ 0, 0, 0, 2, 2, 0, 0, 0 },
{ 0, 0, 2, 2, 2, 0, 0, 0 },
{ 0, 0, 0, 2, 2, 0, 0, 0 },
{ 0, 0, 0, 2, 2, 2, 0, 0 },
{ 0, 0, 6, 2, 2, 2, 0, 0 },
{ 0, 0, 6, 6, 6, 6, 0, 0 },
{ 0, 0, 0, 0, 0, 0, 0, 0 },
{ 0, 0, 0, 0, 0, 0, 0, 0 }
};

const short 6_map1[10][8] = {
{ 0, 0, 0, 0, 0, 0, 0, 0 },
{ 0, 0, 1, 1, 1, 1, 0, 0 },
{ 0, 1, 1, 0, 0, 1, 0, 0 },
{ 0, 1, 7, 4, 0, 1, 0, 0 },
{ 0, 1, 1, 4, 0, 1, 1, 0 },
{ 0, 1, 1, 0, 4, 0, 1, 0 },
{ 0, 1, 0, 4, 0, 0, 1, 0 },
{ 0, 1, 0, 0, 5, 0, 1, 0 },
{ 0, 1, 1, 1, 1, 1, 1, 0 },
{ 0, 0, 0, 0, 0, 0, 0, 0 }
};

const unsigned short 6_cmap[256] = {
0x0000, 0x6C60, 0x140F, 0x0256, 0x0000, 0x5EE0, 0x0012, 0x0000,
0x0000, 0x0000, 0x2C00, 0x0258, 0x0000, 0x0000, 0x0000, 0x0000,
0x4AD4, 0x0000, 0x7000, 0x0257, 0x0000, 0x0000, 0x0000, 0x0000,
0x3FB5, 0x0000, 0x0000, 0x0000, 0x0000, 0x59E0, 0x0012, 0x0000,
0x0000, 0x0000, 0x0000, 0x0000, 0x0000, 0x74E0, 0x000F, 0x0000,
0x0000, 0x0000, 0x4000, 0x0256, 0x0000, 0x0000, 0x0000, 0x0000,
0x0000, 0x0000, 0x0400, 0x0258, 0x0000, 0x0000, 0x0000, 0x0000,
0x4ACE, 0x0000, 0x0000, 0x0000, 0x0000, 0x0000, 0x0000, 0x0000,
0x4B1C, 0x0000, 0x0000, 0x0000, 0x0000, 0x5960, 0x0012, 0x0000,
0x4AF9, 0x0000, 0x0000, 0x0000, 0x0000, 0x4B40, 0x0012, 0x0000,
0x0000, 0x0000, 0x4C00, 0x0256, 0x0000, 0x0000, 0x0000, 0x0000,
0x0000, 0x0000, 0x0800, 0x01FD, 0x0000, 0x0000, 0x0000, 0x0000,
0x4ACD, 0x0000, 0x0000, 0x0000, 0x0000, 0x0000, 0x0000, 0x0000,
0x4B10, 0x0000, 0x0000, 0x0000, 0x0000, 0x5AE0, 0x0012, 0x0000,
0x4AC9, 0x0000, 0x0000, 0x0000, 0x0000, 0x61A0, 0x0012, 0x0000,
0x0000, 0x0000, 0x0800, 0x0256, 0x0000, 0x0000, 0x0000, 0x0000,
0x0000, 0x0000, 0x4C00, 0x01FD, 0x0000, 0x0000, 0x0000, 0x0000,
0x4AC1, 0x0000, 0x2000, 0x0257, 0x0000, 0x0000, 0x0000, 0x0000,
0x3FAB, 0x0000, 0x0000, 0x0000, 0x0000, 0x5920, 0x0012, 0x0000,
0x4AE5, 0x0000, 0x0000, 0x0000, 0x0000, 0x6100, 0x0012, 0x0000,
0x0000, 0x0000, 0x7C00, 0x0256, 0x0000, 0x5CC0, 0x0012, 0x0000,
0x0000, 0x0000, 0x0C00, 0x0258, 0x0000, 0x0000, 0x0000, 0x0000,
0x4ADC, 0x0000, 0x0000, 0x0257, 0x0000, 0x0000, 0x0000, 0x0000,
0x4A56, 0x0000, 0x0000, 0x0000, 0x0000, 0x58E0, 0x0012, 0x0000,
0x4AC4, 0x0000, 0x0000, 0x0000, 0x0000, 0x7580, 0x000F, 0x0000,
0x0000, 0x0000, 0x6400, 0x0256, 0x0000, 0x0000, 0x0000, 0x0000,
0x0000, 0x0000, 0x0C00, 0x0257, 0x0000, 0x0000, 0x0000, 0x0000,
0x4AD6, 0x0000, 0x0000, 0x0000, 0x0000, 0x0000, 0x0000, 0x0000,
0x4B17, 0x0000, 0x0000, 0x0000, 0x0000, 0x5900, 0x0012, 0x0000,
0x0000, 0x0000, 0x0000, 0x0000, 0x0000, 0x7420, 0x000F, 0x0000,
0x0000, 0x0000, 0x0C00, 0x0256, 0x0000, 0x0000, 0x0000, 0x0000,
0x0000, 0x0000, 0x7C00, 0x01FD, 0x0000, 0x0000, 0x0000, 0x7FFF
};

